PGGGGGGGGGGGGGGGGGGG
GGGGGGGGGGGGGGGGGGGG
GGGGGTGGGGGGGGGGTGGG
GGGGGGGGTTTTGGGGGGGG
GGGGTGGGGGGGGGGGGGGG
GGGGGGGGGGGGGGGGGGGG
GGGGGGGGGGTGGGGGGGGG
GGGGGGGGGGGGGGGGGGGG
GGGTGGGGTGGGGGGGTGGG
GGGGGGGGGGGGGGGGGGGG
GGGGGGGGGGGGGGGGGGGG
GGGGGGGGGGTGGGGGGGGG
GGGGGGGGGGGGGGGGTGGG
GGGGGGGGGGGGGGGGGGGG